-1  -1  -1  -1  -1  -1  -1  -1  -1  -1  -1  -1  -1  -1  -1  -1  -1  -1  -1  -1  -1  -1  -1  -1  -1  -1  -1  -1  -1  -1  -1  -1  -1  -1  -1  -1  -1  -1  -1  -1
-1  -1  -1  -1  -1  -1  -1  -1  -1  -1  -1  -1  -1  -1  -1  -1  -1  -1  -1  -1  -1  -1  -1  -1  -1  -1  -1  -1  -1  -1  -1  -1  -1  -1  -1  -1  -1  -1  -1  -1
-1  -1  -1  -1  -1  -1  -1  -1  -1  -1  -1  -1  -1  -1  -1  -1  -1  -1  -1  -1  -1  -1  -1  -1  -1  -1  -1  -1  -1  -1  -1  -1  -1  -1  -1  -1  -1  -1  -1  -1
-1  -1  -1  -1  -1  -1  -1  -1  -1  -1  -1  -1  -1  -1  -1  -1  -1  -1  -1  -1  -1  -1  -1  -1  -1  -1  -1  -1  -1  -1  -1  -1  -1  -1  -1  -1  -1  -1  -1  -1
-1  -1  -1  -1  -1  -1  -1  -1  -1  -1  -1  -1  -1  -1  -1  -1  -1  -1  -1  -1  -1  -1  -1  -1  -1  -1  -1  -1  -1  -1  -1  -1  -1  -1  -1  -1  -1  -1  -1  -1
-1  -1  -1  -1  -1  -1  -1  -1  -1  -1  -1  -1  -1  -1  -1  -1  -1  -1  -1  -1  -1  -1  -1  -1  -1  -1  -1  -1  -1  -1  -1  -1  -1  -1  -1  -1  -1  -1  -1  -1
-1  -1  -1  -1  -1  -1  -1  -1  -1  -1  -1  -1  -1  -1  -1  -1  -1  23  -1  -1  -1  -1  -1  -1  -1  -1  -1  -1  -1  -1  -1  -1  -1  -1  -1  -1  -1  -1  -1  -1
-1  -1  -1  -1  -1  -1  -1  -1  -1  -1  -1  -1  -1  -1  -1  -1  -1  30  -1  -1  -1  -1  -1  -1  -1  -1  -1  -1  -1  -1  -1  -1  -1  -1  -1  -1  -1  -1  -1  -1
-1  -1  26  63  -1  -1  -1  -1  23  56  -1  -1  -1  -1  -1  -1  -1  37  46  45  -1  -1  -1  -1  -1  -1  -1  -1  -1  -1  -1  -1  -1  -1  -1  -1  -1  -1  -1  -1
-1  -1  17  18  19  -1  20  -1  30  18  -1  -1  -1  -1  -1  -1  -1  0  1  2  -1  -1  -1  63  -1  -1  -1  -1  -1  -1  -1  -1  -1  -1  -1  -1  -1  -1  -1  -1
-1  -1  -1  -1  -1  -1  -1  -1  37  18  48  45  -1  -1  -1  -1  -1  7  8  9  -1  -1  -1  44  23  -1  -1  -1  -1  -1  -1  -1  -1  -1  -1  -1  -1  -1  -1  -1
-1  -1  -1  -1  -1  -1  47  -1  0  1  1  2  -1  10  -1  -1  36  14  15  16  -1  -1  44  44  30  -1  -1  -1  -1  -1  -1  -1  -1  -1  -1  -1  -1  -1  -1  -1
-1  -1  23  -1  -1  -1  10  28  14  15  15  16  -1  -1  -1  -1  36  -1  -1  -1  -1  -1  55  55  30  -1  -1  -1  -1  -1  -1  -1  -1  -1  -1  -1  -1  -1  -1  -1
-1  -1  37  48  39  -1  -1  28  -1  -1  -1  -1  -1  -1  -1  23  36  -1  -1  -1  -1  29  0  2  30  -1  -1  -1  -1  -1  -1  -1  -1  -1  -1  -1  -1  -1  -1  -1
-1  -1  0  1  2  68  -1  28  54  54  -1  -1  -1  23  -1  30  36  -1  -1  -1  -1  29  7  9  38  -1  -1  -1  -1  -1  -1  -1  -1  -1  -1  -1  -1  -1  -1  -1
-1  36  7  8  9  -1  -1  3  4  5  69  -1  47  38  48  38  36  -1  -1  56  23  0  1  1  2  -1  -1  19  -1  -1  -1  -1  -1  -1  -1  -1  -1  -1  -1  -1
-1  36  14  15  16  -1  -1  -1  -1  -1  21  -1  0  1  1  1  2  -1  42  42  30  7  8  8  9  -1  -1  19  -1  -1  -1  -1  -1  -1  -1  -1  -1  -1  -1  -1
-1  36  -1  -1  -1  -1  -1  -1  -1  -1  21  -1  7  8  8  8  9  -1  -1  48  38  14  15  15  16  -1  -1  19  19  -1  -1  -1  -1  -1  -1  -1  -1  -1  -1  -1
-1  36  -1  -1  -1  -1  -1  -1  -1  -1  21  -1  7  8  8  8  9  -1  3  4  5  -1  -1  -1  -1  -1  -1  19  19  -1  -1  -1  -1  -1  -1  -1  -1  -1  -1  -1
69  29  61  61  48  45  -1  -1  -1  -1  21  45  7  8  11  8  9  39  54  54  68  -1  -1  -1  -1  -1  -1  19  19  48  -1  -1  -1  -1  -1  -1  -1  -1  -1  -1
1  1  1  1  1  2  -1  34  34  -1  0  1  1  1  1  1  1  1  1  2  -1  34  34  34  34  -1  0  1  1  1  -1  -1  -1  -1  -1  -1  -1  -1  -1  -1
8  8  8  8  8  9  40  40  40  40  7  8  8  8  8  8  8  8  8  9  40  40  40  40  40  40  7  8  8  8  -1  -1  -1  -1  -1  -1  -1  -1  -1  -1
