0  1  1  1  1  1  1  1  1  1  1  1  1  1  1  1  1  1  1  1  1  1  1  1  1  1  1  1  1  2
8  -1  -1  -1  -1  -1  -1  -1  -1  -1  -1  -1  -1  -1  -1  -1  -1  -1  -1  -1  -1  -1  -1  -1  -1  -1  -1  -1  -1  10
8  -1  -1  -1  -1  -1  -1  -1  -1  -1  -1  -1  -1  -1  -1  -1  -1  -1  -1  -1  -1  -1  -1  -1  -1  -1  -1  -1  -1  10
8  0  1  1  1  2  -1  -1  -1  -1  -1  -1  -1  -1  -1  -1  -1  -1  -1  -1  -1  -1  -1  -1  -1  -1  -1  -1  -1  10
8  8  9  9  9  10  -1  -1  -1  -1  -1  -1  -1  -1  -1  -1  -1  -1  -1  -1  -1  -1  -1  -1  -1  -1  -1  -1  -1  10
8  16  17  17  17  18  -1  -1  -1  -1  -1  -1  -1  -1  -1  -1  -1  -1  -1  -1  -1  -1  -1  -1  -1  -1  -1  -1  -1  10
8  -1  -1  -1  -1  -1  -1  0  1  1  1  2  -1  -1  -1  -1  0  1  1  1  2  -1  -1  -1  0  1  1  1  2  10
8  -1  -1  -1  -1  -1  -1  8  9  9  9  10  -1  -1  -1  -1  8  9  9  9  10  -1  -1  -1  8  9  9  9  10  10
8  -1  -1  -1  -1  -1  -1  8  9  9  9  10  -1  -1  -1  -1  -1  -1  -1  -1  -1  -1  -1  -1  8  9  9  9  10  10
8  -1  -1  -1  -1  -1  -1  -1  -1  -1  -1  -1  -1  -1  -1  -1  -1  -1  -1  -1  -1  -1  -1  -1  -1  -1  -1  -1  -1  10
16  1  1  1  1  1  1  1  1  1  1  1  1  1  32  9  9  9  33  1  1  1  1  1  1  1  1  1  1  18